7,8,8,8,8,8,8,9,
6,0,0,0,0,0,0,6,
6,0,0,0,0,0,0,6,
6,0,0,0,6,0,0,6,
6,0,0,0,0,0,0,6,
6,0,0,0,0,0,0,6,
6,0,0,0,0,0,0,6,
5,5,5,5,5,5,5,5,